苛斂誅求|가렴주구|세금을 너무 거두어 들이고 재산을 함부로 빼앗는 일
佳人薄命|가인박명|여자의 얼굴이 너무 빼어나면 삶이 순탄하지 않다
刻骨難忘|각골난망|은덕을 입어 고마운 마음이 뼛속까지 스며 잊히지 않는다
刻骨痛恨|각골통한|뼈에 사무치도록 마음 속 깊이 맺힌 원한
各自圖生|각자도생|제각기 살아 나갈 길을 꾀한다
角者無齒|각자무치|한 사람이 모든 재주나 복을 다 가질 수 없다
甘言利說|감언이설|남의 비위를 맞추기 위한 달콤하고 이로운 말
甘呑苦吐|감탄고토|자기 비위에 맞으면 삼키고 싫으면 내뱉는다
改過遷善|개과천선|지난 나쁜 잘못을 바르게 고쳐서 착하게 된다
蓋棺事定|개관사정|죽은 뒤에야 사람의 참다운 평가가 내려진다
去頭截尾|거두절미|앞뒤로 길게 이야기하지 않고 본론으로 들어간다
乾坤一擲|건곤일척|단판으로 운명을 결정한다는 말
見蚊拔劍|견문발검|모기를 보고 칼을 빼든다
見物生心|견물생심|물건을 보면 그것을 가지고 싶은 마음이 생긴다
結者解之|결자해지|일을 저지른 사람이 그 일을 해결해야 한다
結草報恩|결초보은|죽어서도 은혜를 잊지 않고 꼭 갚는다
輕擧妄動|경거망동|함부로 가볍게 하는 짓
傾國之色|경국지색|나라가 기울어질 정도로 왕의 마음을 사로잡는 미인
敬而遠之|경이원지|겉으로는 받드는 척하면서 속으로는 멀리한다
驚惶罔措|경황망조|놀라고 두려워서 어쩔 바를 모른다
鷄卵有骨|계란유골|달걀에도 뼈가 있다. 운수가 나쁜 사람은 모처럼 좋은 기회를 만나도 역시 일이 잘 안된다
孤掌難鳴|고장난명|손바닥 하나로는 박수를 칠 수 없다. 혼자 힘으론 일을 해내기가 어렵다
苦盡甘來|고진감래|고생 끝에 낙이 온다
高枕短命|고침단명|베개를 높이 베면 오래 살지 못한다
骨肉相殘|골육상잔|같은 피를 나눈 사람끼리 서로 싸우는 일
功過相半|공과상반|공로와 과실이 반반
公明正大|공명정대|일이나 하는 짓이 옳고 바르다
空中樓閣|공중누각|공중에 뜬 집처럼 터무니 없는 말
過恭非禮|과공비례|지나치게 공손하면 오히려 예의에 벗어난다
過猶不及|과유불급|정도가 지나치면 뜻하는 바에 이르지 못한다
管鮑之交|관포지교|관중과 포숙의 우정처럼 아주 친한 친구 사이
刮目相對|괄목상대|놀라서 눈을 비비고 다시 바라본다. 무엇이 대단히 발전하였다
矯角殺牛|교각살우|뿔을 고치려다 소를 죽인다. 작은 일에 힘쓰다가 큰 일을 망친다
巧言令色|교언영색|남에게 아첨하려고 듣기 좋게 꾸미는 말과 얼굴빛
口尙乳臭|구상유취|입에서 젖내가 난다. 몹시 유치하다
